R 1920 1080
NO ./textures/ter.xpm
WE ./textures/ignis.xpm
SO ./textures/aer.xpm
EA ./textures/aqua.xpm
S ./textures/yoda.xpm
F 192,192,192   
C 0,191,255

          1111111111111111111111111
          1000000000110000000000001
          1011000001110000002220001
          1001000000000000000022001
11111111111100000111000000000000101
10000000001100000111011111011111101
11110111111111011100000010000111001
1111011111111101110101001000001 101
11000000110101011100000010002111101 
10002000000000001100000010022111111
100000000000000011010100120021
11000001110101011111011112N001
11110111 1110121 1011110000001
11111111 1111111 1111111111111